bbbbbbbbbbbbbbb
b0000000000000b
b000bbbbb00000b
bbb00000000000b
b000000000b000b
b000000000b000b
b000000000b000b
b00b000000b000b
b00b0000000h00b
b00b0000000000b
b0t0000bbbbbbbb
b0000000000000b
b0bb0000000000b
b0b000t000000bb
bbbbbbbbbbbbbbb
