b00000000000000
b00000000000000
b000bbbbb000000
bbb000000000000
00b0000000b0000
00bb000000b0000
0000000000b0000
000b000000b0000
000b00000000000
000b00000000000
0000000bbbbbbb0
000000000000000
00bb0000000000b
00b0000000000bb
00b0000000bbbbb
